0000000000
0000011110
0001111111
0000000000
0111000111
0111111111
0000000000
0000000000
0000000000
0000000000

